ψψψψψψψψψψψψψψψψψψψψψψψψψψψψψψψψψψψψψψψψψψψψψψψψψψψψψψψψ
ψψψψψ                                           ψψψψψψψψ
ψψψ    ψψψψψψψψψψψψψψψψψ   ψψψψψψψψψψψψψψ   ψψ   ψψψψψψψ
ψψ    ψψψψψψψψψψψψψψψψψ    ψψψψψψψψψψψψψ    ψψψψж ψψψψψψ
ψ    ψψ      ж       ψψ   ψψψ  _.-.-.     ψψψψψψψ  ψψψψψ
ψ   ψψψψ                 ψψψ.-',__'.';   ψψψψψψψψ  ψψψψψ
ψψ   ψψψψψψψψψψψψψψψψψψψψψψ/___(__)__';  ψψψψψψψψψ  ψψψψ
ψψψ  ψψψψψψψψψψψψψψψψψψψψψψψ             ψψψψψψψψψψ  ψψψ
ψψψф  ψψψψψψψψψψψψψψψψψψψψψψψψψψψψψψψψψψψψψψψψψψψψψ  ψψψ
<::::::::::::::::::::::::::::::::::::::::::ж:::::::::::>
ψψψψψψψψψф   ψψψψψψψψψψψψψψψψψψψψψψψψψψψψψψψψψψψψψψψψψψψ
ψψψψψψψψ    ψψψψψψψψψψ    ж    ψψψψψψψψψψψ       ψψψψψψψ
ψψψψψψψψψ   ψψψψψψψψψψ        ψψψψψψψψψψψ   ψψψ   ψψψψψψ
ψψψψψψψψψψ   ψψψψψψψψψψ      ψψψψψψψψψψψψψ        ψψψψψψ
ψψψψψψψψψψψ   ψψψψψψψψψψψ   ψψψψψψψψψψψψψψψψψψ   ψψψψψψψ
ψψψψψψψψψψψψ                 ψψψψψψψψψψψψψψψψψψ   ψψψψψψ
ψψψψψψψψψψψψψψψψψψψψψψψψψψψ   ψψψψψψψψψψψψψψψψψψ    ψψψψ
ψψψψψψψψψψψψψψψψψψψψψψψψψψψψ   ψψψψψψψψψψψψψψψψψψ   ψψψψ
ψψψψψψψψψψψψψψψψψψψψψψψψψψψψψ                      ψψψψψ
ψψψψψψψψψψψψψψψψψψψψψψψψψψψψψψψψψψψψψψψψψψψψψψψψψψψψψψψψ
